########################
#       #              #
#       #              #
#    #  #              #
#       +      # #     #
#       #      # #     #
## ######      ###     #
## ######              #
#       #     #        #
#   #        #         #
#   #       #          #
#       #              #
########################
