#########
#       #
#       #
#    #  #
#       #
#       #
## ######
## ######
#       #
#       #
#       #
#       #
#########
