########################
#       #              #
#       #              #
#    #  #              #
#              ###     #
#       #      ###     #
## ######      ###     #
## ######              #
#       #              #
#   #   #              #
#    #  #              #
#       #              #
########################
