########################
#       #              #
#       #              #
#    #  #              #
#       +      # #     #
#       #      # #     #
## ######      ###     #
## ######              #
#       #              #
#   #                  #
#    #                 #
#       #              #
########################
