#############################
#       #                   #
#       #                   #
#    #  #                   #
#                           #
#       #                   #
## ######                   #
## ######                   #
#       #                   #
#   #   #                   #
#    #  #                   #
#       #                   #
#############################
